10
 - - -   - -   -   
 j j|j j|j j j j|j|
 - -   -   -   - - 
 j|j j j|j j|j|j|j 
 - - - - -       - 
 j j|j|j j j|j j|j 
       - - -     - 
|j|j|j j|j j|j|j j|
   -   - -     - - 
|j|j j j j|j|j|j j 
 - -   -       - - 
 j|j|j|j j j j|j|j 
       - -   -   - 
|j|j j j|j j j|j|j 
 -   -   -   -   - 
|j|j j|j j|j|j j|j 
     - -   -   -   
|j|j|j j|j|j j|j|j|
   -   - - -     - 
